Swiss_Cheese
40 400
##e###P##e##
#1111111111#
#L11111111L#
#1111111111#
#222E22U222#
#          #
#2222222222#
#1111111111#
#1111111111#
#1111111111#
#1111111111#
#          #
#          #
#          #
#          #
#A        ^#
#5432112345#
#          #
#          #
#          #
#          #
#          #
#          #
#          #
#          #
#          #
#          #
#          #
#          #
#          #
#          #
#          #
#          #
#          #
#          #
#          #
#          #
#          #
#          #
#          #
#          #
#          #
/##      ###
