20x20
4
Small is wonderful
Bjørn Stabell
xxxxxxxxxxxxxxxxxxxx
x                  x
x                  x
x                  x
x                  x
x                 *x
x                 ax
x                  x
x*                 x
xs                 x
x                  x
x                  x
x                  x
x                  x
x                  x
x*                 x
xF                 x
xs                 x
x   *       *     *x
xxxxxxxxxxxxxxxxxxxx
