49x50
4
DoggyStyle
Kjell Irgens
xxxxxxxxxxxxxxxxxxxxxxxxxxxxxxxxxxxxxxxxxxxxxxxxx
x...............................................x
x...............................................x
x...............................................x
x...............................................x
x...............................................x
x...............................................x
x...............................................x
x...............................................x
x...............................................x
x...............................................x
x...............................................x
x...............................................x
x...............................................x
x...............................................x
x...............................................x
x...............................................x
x...............................................x
x...............................................x
x...............................................x
x...............................................x
x...............................................x
x...............................................x
x...............................................x
x...............................................x
x...............................................x
x...............................................x
x...............................................x
x...............................................x
x...............................................x
x...............................................x
x...............................................x
x...............................................x
x...............................................x
x...............................................x
x...............................................x
x...............................................x
x...............................................x
x...............................................x
x...............................................x
x...............................................x
x...............................................x
x...............................................x
x...............................................x
x...............................................x
x...............................................x
x...............................................x
x..r...r...r...r...r..r...r...r...r...r...r...r.x
x.*F*.*F*.*F*.*F*.*F.*F*.*F*.*F*.*F*.*F*.*F*.*F*x
xxxxxxxxxxxxxxxxxxxxxxxxxxxxxxxxxxxxxxxxxxxxxxxxx





