30x30
0
Some unpleasant surprises for everyone
Tom Grydeland
xxxxxxxxxxxxxxxxxxxxxxxxxxxxxx
x  +       >r -<           > x
x          dFf <             x
x   qw      c              * x
x   as                       x
x                          < x
x                            x
x                           0x
x                           1x
x                           2x
x                           3x
x                           4x
x                           5x
x                           6x
x                           7x
x                           8x
x                           9x
x             r              x
x           <d*f>            x
x             c              x
x                            x
x                            x
x                            x
x                            x
x qs                         x
xqs                          x
xs                           x
x............................x
x+.*.+......................qx
xxxxxxxxxxxxxxxxxxxxxxxxxxxxxx
