Lizard
16 30
############
#          #
#    II    #
#3        3#
#          #
#    PP    #
#   R  R   #
#          #
#          #
#          #
#          #
#   WWWW   #
#  DDDDDD  #
#          #
#          #
#          #
#          #
#          #
#          #
#          #
#          #
#          #
#    #     #
# # #  # # #
#     \    #
#          #
#          #
#          #
#          #
#          #
#          #
#          #
#          #
#          #
#          #
#          #
#          #
#          #
#          #
#          #
#          #
#          #
#          #
