Baboon
40 400
############
#1111111111#
#1222222221#
#1211111121#
#121    121#
#121 ^# 121#
#121    121#
#1211111121#
#1222222221#
#1111111111#
#%%%%SS%%%%#
#    jA    #
#          \
#          #
#    aa    #
#          #
#          #
#          #
#          #
#          #
#          #
#          #
#          #
#          #
#          #
#          #
#          #
#          #
#          #
#          #
#          #
#          #
#          #
#          #
#          #
#          #
#          #
#          #
#          #
#          #
#          #
#          #
##  #  #  ##
