Snail
30 90
############
#b11111111b#
#1111111111#
#1111111111#
#2222222222#
#          #
# 22222222 #
# 11111111 #
# 11177111 #
# 11111111 #
# 11111111 #
#          #
#          #
#          #
#          #
#          #
#          #
#          #
#          #
#0        0#
# 0      0 #
#          #
#          #
#          #
#          #
#          #
#          #
#          #
#          #
#          #
#          #
#          #
#          #
#          #
#          #
#          #
#          #
#          #
#          #
#          #
#          #
#          #
###      /##
