Termite
32 280
############
#AIIICXIIIA#
#I#       I#
#  1  1  1 #
#T  S   S  #
#  S MDS   #
#1   %    1#
# %  M%   R#
#    S   % #
#   1  1   #
# %   S  D #
#R D %   % #
#1   T%   1#
#   S   S  #
#  S  1S   #
#1   #   #1#
# #   #    #
#c  b  b  c#
#          #
#          #
#  %    %  #
#          #
#R   %%   R#
#          #
#  ^    #  #
#          #
#          #
#          #
#          #
#          #
#          #
#          #
#          #
#          #
#          #
#          #
            
            
#          #
#          #
    #  #    
            
#    ##    \
