Wolf
30 700
############
#  C    C  #
# 12 00 21 #
# 13 00 31 #
# 14 DU 41 #
# 13 00 31 #
# 12 SS 21 #
#          #
# 12 11 21 #
# 12IIII21 #
# 12 WW 21 #
# 12 55 21 #
# 12IIII21 #
# 12 11 21 #
#          #
#          #
#          #
#          #
#          #
#          #
#          #
#          #
#          #
#          #
#          #
#          #
#          #
#          #
#          #
#          #
#          #
#          #
#          #
#          #
#          #
#          #
#          #
#          #
#          #
#          #
#          #
#          #
/          #
