Black_Hole
60 800
############
#          #
#IIIIIIIIII#
#    GU    #
#IIIIIIIIII#
#ES      SE#
#S        S#
#          #
#2222222222#
# I IIII I #
#2222442222#
#          #
#          #
#          #
#          #
#          #
#          #
#          #
#          #
#          #
#          #
#          #
#          #
#          #
#          #
#          #
#          #
#          #
#          #
#          #
#          #
#          #
#          #
#          #
#          #
#          #
#          #
#          #
#          #
#          #
#          #
#          #
#    /#    #
