Cobra
60 300
############
#d11111111d#
#11 1CM1 11#
#11 1111 11#
#1#      #1#
#111 11 111#
#U11 11 11U#
#111 11 111#
#1R      R1#
#11 1111 11#
#11 1111 11#
#11 1111 11#
#A1      1A#
#111 11 111#
#H11 11 11H#
#111 11 111#
#1R      R1#
#1111111111#
#1111441111#
#1114114111#
#S11111111S#
#011    110#
#D11 ^# 11D#
#011    110#
#S11111111S#
#1114114111#
#1111441111#
#1111111111#
#1R      R1#
#111 11 111#
#111 11 111#
#111 11 111#
##1      1##
#S11111111S#
#          #
#          #
#          #
#          #
#          #
#          #
#          #
#          #
#          \
