Butterfly
30 100
#####AA#####
#          #
# 0 #11# 0 #
#2# #  # #2#
# # #11# # #
# # #11# # #
#2  #  #  2#
# # #11# # #
# # #11# # #
#2# #  # #2#
#   #11#   #
# S #11# S #
#2D #  # D2#
# S #11# S #
#   #11#   #
#2# #  # #2#
# # #11# # #
# # #11# # #
#2  #  #  2#
# 0 #jj# 0 #
# # #EU# # #
# #5#II#5# #
#   #^##   #
#          #
#          #
#          #
#          #
#          #
#          #
#          #
#          #
#          #
#          #
#          #
#          #
#          #
#          #
#          #
#          #
#          #
            
#          #
###  ##  ##\
