Zebra
50 400
############
#IIIIIIIIII#
#IIIIIIIIII#
#IIIIIIIIII#
#          #
#2222222222#
#1M111111M1#
#1111111111#
#          #
#2222222222#
#1111111111#
#1111111111#
#          #
#2222222222#
#1111111111#
#1111LL1111#
#          #
#2222222222#
#1111111111#
#1111SS1111#
#          #
#2222222222#
#1111111111#
#1111111111#
#          #
#2222222222#
#1111111111#
#1111LL1111#
#          #
#4447777444#
#1111111111#
#1111111111#
#          #
#1111111111#
#1111111111#
#1111111111#
#          #
#1111111111#
#1111111111#
#1111111111#
#          #
#          #
/2222222222#
