Wasp
40 200
############
#C11111111C#
# 11111111 #
# 1SU9DUS1 #
# 222LL222 #
#          #
# 22222222 #
# 11111111 #
# 11111111 #
# 111^9111 #
# 11111111 #
#          #
#          #
#A        A#
#          #
#          #
#          #
#          #
#          #
/A        A#
#          #
#   WWWW   #
#          #
#          #
#          #
#          #
#          #
#          #
#          #
#          #
#          #
#          #
#          #
#          #
#          #
#          #
#          #
#          #
#          #
#          #
#          #
#          #
###      ###
