Diamond
40 70
############
##S  33  S##
#S  3113  S#
#   3113   #
#  311113  #
#  311113  #
# 31111113 #
# 31111113 #
#3111UU1113#
#3111DL1113#
# 31111113 #
# 31111113 #
#  311113  #
#  311113  #
#   3113   #
#S  3113  S#
# S  33  S #
#          \
#          #
#          #
#          #
#          #
#          #
#          #
#          #
#          #
#          #
#          #
#          #
#          #
#          #
#          #
#          #
#          #
#          #
#          #
#          #
#          #
#          #
#          #
#          #
#          #
##        ##
